Angular JS = AngularJS
angular = AngularJS
angularjs = AngularJS
java script = JavaScript
JavaScript = JavaScript
sync fusion = Syncfusion
Syncfusion = Syncfusion
micro soft = Microsoft
Microsoft = Microsoft
jQuery = jQuery
js render = JsRender
JSRender = JsRender
jsview, jsviews  = JsView
js view = JsView
ok = OK
sdk, Sdk = SDK
essential studio = Essential Studio
essential js = Essential JS
dll = assembly or Assembly
dlls = assemblies or Assemblies
visual studio = Visual Studio
uwp = UWP
universal windows platform, universal window, universal windows , Universal Windows = Universal Windows Platform
xaml = XAML
wpf = WPF
silverlight = Silverlight
windowsforms, Windows forms = Windows Forms
winforms = WinForms
angularjs 2 = Angular 2
app store = App Store
Google play store = Google Play Store
Microsoft store = Microsoft Store
asp.net = ASP.NET
.net = .NET
framework = Framework
asp.net mvc = ASP.NET MVC
build in, inbuilt, inbuild, build-in, builtin = Built-in or built-in
chrome web store = Chrome Web Store
Add-ons for Firefox = Add-ons for Firefox
fire fox = Firefox
cordova = Cordova
iphone = iPhone
ipad = iPad
ipod = iPod
ios = iOS
js = JS
knockoutjs = KnockoutJS
knockout js = KnockoutJS
knockout = Knockout
mvc = MVC
Node.js, nodejs = Node.js
nuget, nugets = NuGet
objective-c, objective c = Objective-C
odata = OData
phonegap = PhoneGap
php = PHP
react.js, reactjs = React
reactnative, react native = React Native
require js = RequireJS
requirejs = RequireJS
Tools for Apache Cordova = Tools for Apache Cordova
taco = TACO
typescript = TypeScript
type script = TypeScript
webkit = WebKit
xamarin.android = Xamarin.Android
xamarin.forms = Xamarin.Forms
xamarin.ios = Xamarin.iOS
xcode = Xcode
xamarin forms = Xamarin.Forms
xamarin android = Xamarin.Android
xamarin ios = Xamarin.iOS
json = JSON
ajax = AJAX
xml = XML
css = CSS
xbap = XBAP
qtp = QTP
click once = ClickOnce
clickonce = ClickOnce
html, htm = HTML
cdn = CDN
pdf = PDF
xls = XLS
xlsx = XLSX
exe = EXE or executable
pri = PRI
ng = ng
gantt = Gantt
olap = OLAP
http = HTTP
toc = TOC
bigdata = Big Data
hadoop = Hadoop
google = Google
hbase = HBase
apache hbase = Apache HBase
hdfs = HDFS
mongodb = MongoDB
mongo db = MongoDB
tez = Tez 
apache tez = Apache Tez
oozie = Oozie 
apache oozie = Apache Oozie
gradle = Gradle
intellij = IntelliJ
jdbc = JDBC
hql = HQL
xamarin = Xamarin
lightswitch = LightSwitch
java = Java
windowsphone, windows phone = Windows Phone
windowsphones, windows phones = Windows Phones
csv = CSV
orubase = Orubase
https = HTTPS
www = WWW
vsix = VSIX
webform = Web Form
web form = Web Form
web forms = Web Forms
webforms = Web Forms
linq = LINQ
jpeg = JPEG
docx = DOCX
pmml = PMML
bayes = Bayes'
mozilla = Mozilla
kerberos = Kerberos
rdl = RDL
rdls = RDLC
api = API
ssrs = SSRS
rds = RDS
smtp = SMTP
sydx = SYDX
ondemand = on demand or On demand
syds = SYDS
iis = IIS
mailmerge = Mail merge
mail merge = Mail merge
smartart = SmartArt
smart art = SmartArt
powerpoint = PowerPoint
power point = PowerPoint
acroforms = AcroForms
acro forms = AcroForms
vml = VML
bugzilla = Bugzilla
codabar = Codabar
rgb = RGB
github = GitHub
git hub = GitHub
apache = Apache
mit = MIT
ajaxmin = AjaxMin
ocr = OCR
wcf = WCF
ria = RIA
codeplex = CodePlex
roboto = Roboto
clr = CLR
cli = CLI
calibri = Calibri
msdn = MSDN
codedui = Coded UI
coded ui = Coded UI
QuickTest Professional = QuickTest Professional
leanft = LeanFT
uft = UFT
c# = C#
vb.net = VB.NET
vb = VB
data matrix = Data Matrix
Cartesian = Cartesian
docm = DOCM
dicom = DICOM
ppt = PPT
pptx = PPTX
xlsio = XlsIO
docio = DocIO
rtf = RTF
xmp = XMP
databar = DataBar
smartlabel = SmartLabel
calengine = CalcEngine
ie = IE
internet explorer = Internet Explorer
sso = SSO
single signon = Single Sign-On
single sign-on = Single Sign-On
single sign on= Single Sign-On
activedirectory = Active Directory
active directory = Active Directory
csharp = C Sharp
c sharp = C Sharp
bower = Bower
data base = database or Database
adventure works = AdventureWorks
adventureworks = AdventureWorks
noth wind = Northwind
northwind = Northwind
dbase = dBase
rrule = RRULE
winrt = WinRT
mvvm = MVVM
client profile = Client Profile
Office 2013 = Office 2013
office 2003 = Office 2003
office 16 = Office 16
office 365 = Office 365
share point = SharePoint
sharepoint = SharePoint
microsoft word = Microsoft Word
microsoft excel = Microsoft Excel
microsoft powerpoint = Microsoft PowerPoint
microsoft office xml = Microsoft Office XML
onedrive = OneDrive
microsoft outlook = Microsoft Outlook
ical = iCal
office 2016 = Office 2016
office xp = Office XP
microsoft visio = Microsoft Visio
onenote = OneNote
one note = OneNote
microsoft project = Microsoft Project
power pivot = Power Pivot
visual basic = Visual Basic
visualbasic = Visual Basic
xps = XPS
openxps = OpenXPS
aero = Aero
windows aero = Windows Aero
hijri = Hijri
pantone = Pantone
gif = GIF
metafile = Metafile
truetype = TrueType
true type = TrueType
gdi = GDI
wmf = WMF
autofit = AutoFit
auto shape = AutoShape
auto shapes = AutoShapes
autoshape = AutoShape
autoshapes = AutoShapes
internet = Internet
xlam = XLAM
addins = Add-ins
add ins = Add-ins
dotm = DOTM
tiff = TIFF
dotx = DOTX
epub = EPUB
ms office = Microsoft Office
interop = Interop
jpg = JPG
tif = TIF
exif = Exif
sql = SQL
MS Access = Microsoft Access
MS Office = Microsoft Office
MS Word = Microsoft Word
MS Excel = Microsoft Excel
MS Powerpoint = Microsoft PowerPoint
oledb = OLEDB
odbc = ODBC
macd = MACD
qat = QAT
spread sheet = Spreadsheet or spreadsheet
nonblank = non-blank
nonnumeric = non-numeric
nonprintable = non-printable
jsonp = JSONP
svg = SVG
bpmn=BPMN
adhoc = ad hoc
kmph = kph
usa = USA
uk = UK
kpi = KPI
report server = Report Server
sqlite = SQLite
twitter = Twitter
facebook = Facebook
face book = Facebook
mysql = MySQL
apache spark = Apache Spark
salesforce = Salesforce
sales force = Salesforce
spark sql = Spark SQL
zorder = Z-order
borland = Borland
entity framework = Entity Framework
entityframework = Entity Framework
kml = KML
cpu = CPU
gb = GB
hilo = HiLo
png = PNG
bmp = BMP
hiloopenclose=HiLoOpenClose
linux = Linux
Angular = AngularJS
nuget = NuGet
active directory = Active Directory